XXXXXXXXXXXXXXXXXX
X32311232312X1c31X
X1a31X323123X2312X
X1231X312312X1231X
X2312X122231X1232X
XXXXXX31X12223131X
X1231312X23231312X
X2bX3d23X23132e12X
X32X2121X31223212X
XXXXXXXXXXXXXXXXXX